########
#      #
# S  # #
#    # #
# ###  #
# #   ##
#   # E#
########