########
#S    #
#      #
#     #
#     E#
# # # #
 # # #