#######################################################################################################
#                                                                                    S                #
#                                                                                                     #
#                                                                                                     #
#                                                                                                     #
#                                                                                                     #
#     E                                                                                               #
#######################################################################################################