########
#S    S#
#      #
#      #
#      #
#     E#
########