########
#S     #
#      #
#      #
#      #
#      #
########