########
#      #
#      #
#      #
#      #
#     E#
########